##ftuubf##
##########
f########f
t########t
l###TT###r
l###TT###r
b########b
f########f
##########
##ftddbf##