##b####BB####b##
################
####T######T####
ll####tfft####rr
ll####tfft####rr
####T######T####
################
##b####BB####b##
