b##uu##t
########
##f##f##
l###T##r
l##T###r
##f##f##
########
t##dd##b