f#############f
####t#####b####
#######T#######
l#############r
l#############r
#######T#######
####b#####t####
f#############f